1 1 1 1 1 1 1 1 1 1 1 1 1 1 1 1 1 1 1 1 1 1 1 1 1 1 1 1 1 1 1 1 1 1 1 1 1 1 1 1
1 1 1 1 1 1 1 1 1 1 1 3 5 5 5 5 5 5 5 5 5 5 5 5 5 5 5 5 5 5 5 5 5 5 5 5 8 1 1 1
1 1 1 1 1 1 1 1 1 1 1 2 0 0 0 0 0 0 0 0 0 0 0 0 0 0 0 0 0 0 0 0 0 0 0 0 4 1 1 1
1 1 1 1 1 1 1 1 1 1 1 2 0 0 0 0 0 0 0 0 0 0 0 0 0 0 0 0 0 0 0 0 0 0 0 0 4 1 1 1
1 1 1 1 1 1 1 1 1 1 1 2 0 0 0 0 0 0 0 0 0 0 0 0 0 0 0 0 0 0 0 0 0 0 0 0 4 1 1 1
1 1 1 1 1 1 1 1 1 1 1 2 0 0 0 11 6 6 6 6 6 6 6 6 6 6 6 6 6 6 6 6 10 0 0 0 4 1 1 1
1 1 3 5 5 5 5 5 5 5 5 9 0 0 0 4 1 1 1 1 1 1 1 1 1 1 1 1 1 1 1 1 2 0 0 0 4 1 1 1
1 1 2 0 0 0 0 0 0 0 0 0 0 0 0 4 1 1 1 1 1 1 1 1 1 1 1 1 1 1 1 1 2 0 0 0 4 1 1 1
1 1 2 0 0 0 0 0 0 0 0 0 0 0 0 4 1 1 1 1 1 1 1 1 1 1 1 1 1 1 1 1 2 0 0 0 4 1 1 1
1 1 2 0 0 0 0 0 0 0 0 0 0 0 0 4 1 1 1 1 1 1 1 1 1 1 1 1 1 1 1 1 2 0 0 0 4 1 1 1
1 1 2 0 0 0 12 6 6 6 6 6 6 6 6 7 1 1 1 1 1 1 1 1 1 1 1 1 1 1 1 1 2 0 0 0 4 1 1 1
1 1 2 0 0 0 4 1 1 1 1 1 1 1 1 1 1 1 1 1 1 1 1 1 1 1 1 1 1 1 1 1 2 0 0 0 4 1 1 1
1 1 2 0 0 0 4 1 1 1 1 1 1 1 1 1 1 1 1 1 1 1 1 1 1 1 1 1 1 1 1 1 2 0 0 0 4 1 1 1
1 1 2 0 0 0 4 1 1 1 1 1 1 1 1 1 1 1 1 1 1 1 1 1 1 1 1 1 1 1 1 1 2 0 0 0 4 1 1 1
1 1 2 0 0 0 4 1 1 1 1 1 1 1 1 1 1 1 1 1 1 1 1 1 1 1 1 1 1 1 1 1 2 0 0 0 4 1 1 1
1 1 2 0 0 0 4 1 1 1 1 1 1 1 1 1 1 1 1 1 1 1 1 1 1 1 1 1 1 1 1 1 2 0 0 0 4 1 1 1
1 1 2 0 0 0 4 1 1 1 1 1 1 1 1 1 1 1 1 1 1 1 1 1 1 1 1 1 1 1 1 1 2 0 0 0 4 1 1 1
1 1 2 0 0 0 4 1 1 1 1 1 1 1 1 1 1 1 1 1 1 3 5 5 5 5 5 5 5 5 5 5 9 0 0 0 4 1 1 1
1 1 2 0 0 0 4 1 1 1 1 1 1 1 1 1 1 1 1 1 1 2 0 0 0 0 0 0 0 0 0 0 0 0 0 0 4 1 1 1
1 1 2 0 0 0 4 1 1 1 1 1 1 1 1 1 1 1 1 1 1 2 0 0 0 0 0 0 0 0 0 0 0 0 0 0 4 1 1 1
1 1 2 0 0 0 4 1 1 1 1 1 1 1 1 1 1 1 1 1 1 2 0 0 0 0 0 0 0 0 0 0 0 0 0 0 4 1 1 1
1 1 2 0 0 0 4 1 1 1 1 1 1 1 1 1 1 1 1 1 1 2 0 0 0 6 6 6 6 6 6 6 6 6 6 6 7 1 1 1
1 1 2 0 0 0 4 1 1 1 1 1 1 1 1 1 1 1 1 1 1 2 0 0 0 1 1 1 1 1 1 1 1 1 1 1 1 1 1 1
1 1 2 0 0 0 4 1 1 1 1 1 1 1 1 1 1 1 1 1 1 2 0 0 0 1 1 1 1 1 1 1 1 1 1 1 1 1 1 1
9
110 720
110 200
200 260
320 260 
320 210 
1010 210
1010 560
680 560
590 560
60
0 0 0 0 0 0 0 0 0 0
0 0 0 0 0 0 0 0 0 0
1 1 1 1 1 2 2 2 2 2
1 1 1 1 1 2 2 2 2 2
2 2 2 2 2 1 1 1 1 1
2 2 2 2 2 3 3 3 3 3


