2 0 0 0 2 2 2 2 2 2 2 2 2 2 2 2 2 2 2 2 2 2 2 2 2 2 2 2 2 2 2 2 2 2 2 3 3 3 2 2
2 0 0 0 2 1 1 1 1 1 1 1 1 1 1 1 1 1 1 1 1 1 1 1 1 1 1 1 1 1 1 1 1 1 2 0 0 0 2 2
2 0 0 0 2 1 1 1 1 1 1 1 1 1 1 1 1 1 1 1 1 1 1 1 1 1 1 1 1 1 1 1 1 1 2 0 0 0 2 2
2 0 0 0 2 1 1 1 1 1 1 1 1 1 1 1 1 1 1 1 1 1 1 1 1 1 1 1 1 1 1 1 1 1 2 0 0 0 2 2 
2 0 0 0 2 1 1 1 1 1 1 1 1 1 1 1 1 1 1 1 1 1 1 1 1 1 1 1 1 1 1 1 1 1 2 0 0 0 2 2
2 0 0 0 2 1 1 1 1 1 1 1 1 1 1 1 1 1 1 1 1 1 1 1 1 1 1 1 1 1 1 1 1 1 2 0 0 0 2 2
2 0 0 0 2 1 1 1 1 1 1 1 1 1 1 1 1 1 1 1 1 1 1 1 1 1 1 1 1 1 1 1 1 1 2 0 0 0 2 2
2 0 0 0 2 1 1 1 1 1 1 1 1 2 2 2 2 2 2 2 2 2 2 2 2 2 2 2 2 1 1 1 1 1 2 0 0 0 2 2
2 0 0 0 2 1 1 1 1 1 1 1 1 2 0 0 0 0 0 0 0 0 0 0 0 0 0 0 2 1 1 1 1 1 2 0 0 0 2 2
2 0 0 0 2 1 1 1 1 1 1 1 1 2 0 0 0 0 0 0 0 0 0 0 0 0 0 0 2 1 1 1 1 1 2 0 0 0 2 2
2 0 0 0 2 1 1 1 1 1 1 1 1 2 0 0 0 0 0 0 0 0 0 0 0 0 0 0 2 1 1 1 1 1 2 0 0 0 2 2
2 0 0 0 2 1 1 1 1 1 1 1 1 2 0 0 0 2 2 2 2 2 2 2 2 0 0 0 2 1 1 1 1 1 2 0 0 0 2 2
2 0 0 0 2 1 1 1 1 1 1 1 1 2 0 0 0 2 1 1 1 1 1 1 2 0 0 0 2 1 1 1 1 1 2 0 0 0 2 2
2 0 0 0 2 1 1 1 1 1 1 1 1 2 0 0 0 2 1 1 1 1 1 1 2 0 0 0 2 1 1 1 1 1 2 0 0 0 2 2
2 0 0 0 2 1 1 1 1 1 1 1 1 2 0 0 0 2 1 1 1 1 1 1 2 0 0 0 2 1 1 1 1 1 2 0 0 0 2 2
2 0 0 0 2 1 1 1 1 1 1 1 1 2 0 0 0 2 1 1 1 1 1 1 2 0 0 0 2 1 1 1 1 1 2 0 0 0 2 2
2 0 0 0 2 1 1 1 1 1 1 1 1 2 0 0 0 2 1 1 1 1 1 1 2 0 0 0 2 1 1 1 1 1 2 0 0 0 2 2
2 0 0 0 2 1 1 1 1 1 1 1 1 2 0 0 0 2 1 1 1 1 1 1 2 0 0 0 2 1 1 1 1 1 2 0 0 0 2 2
2 0 0 0 2 1 1 1 1 1 1 1 1 2 0 0 0 2 1 1 1 1 1 1 2 0 0 0 2 2 2 2 2 2 2 0 0 0 2 2
2 0 0 0 2 2 2 2 2 2 2 2 2 2 0 0 0 2 1 1 1 1 1 1 2 0 0 0 0 0 0 0 0 0 0 0 0 0 2 2
2 0 0 0 0 0 0 0 0 0 0 0 0 0 0 0 0 2 1 1 1 1 1 1 2 0 0 0 0 0 0 0 0 0 0 0 0 0 2 2
2 0 0 0 0 0 0 0 0 0 0 0 0 0 0 0 0 2 1 1 1 1 1 1 2 0 0 0 0 0 0 0 0 0 0 0 0 0 2 2
2 0 0 0 0 0 0 0 0 0 0 0 0 0 0 0 0 2 2 2 2 2 2 2 2 2 2 2 2 2 2 2 2 2 2 2 2 2 2 2
2 2 2 2 2 2 2 2 2 2 2 2 2 2 2 2 2 2 2 2 2 2 2 2 2 2 2 2 2 2 2 2 2 2 2 2 2 2 2 2
8
50 100
50 720
440 720
440 360
770 360
770 690
1070 690
1070 -30
50
0 0 0 0 0 0 0 0 0 0
0 0 0 0 0 1 1 1 1 1
1 1 1 2 2 2 1 1 1 1
1 1 2 2 2 2 2 2 2 2
2 2 2 2 2 3 3 3 3 3




